                                                                                                                                          CC               
                                              CCC                                                  C                                                       
                       #######                                          ###########    ###########   ####    #####  #####             ##                   
                               F         C                                          C                             FFF                                     C
              ######               ##########     ###############       ###########                  F       #####   CCC      ##                ###########
                                                                    C               C               F      CC                                              
###########            #########                  ###############       ###########    ###########       ##  #####  ########      #########################E