                                                                                                           CCC      
                                                       C C                          C  C  C       F F F F  CCC      
                        ##################     ############               ###############################           
                        F                         FF              FF                         C     F F F            
############           FFF                    ########       #############                                   #######
                      FFFFF    C C                                     C C                     C C                  
####################################   C   #########            ####################################################E