                                    C                                                  
                  FFFFFFF          CCC                                                 
#########################         C C C    #################                           
                  FFFFFFF           C             FFFFFFFFFF     C                 C   
            #####                                             #######           #######
                    C C C C C                                             C            
                ############################                           #######         E